111111111111111111111111111111111
100000000000000C00000000000000001
101001010010000010100100000010101
1010010010101010001001000000101E1
1P0000000C00C000000001000000000C1
111111111111111111111111111111111