111111111111111111111111111111111
100000000000000C00000000000000001
1010010100100000101001000000101011
1010010010101010001001000000101E1
1P0000000C00C000000001000000000C1
111111111111111111111111111111111